Id,dateB,lProduced,deductions,toPay,idProducer
1,2023-09-13,1000,50,950,1
2,2023-09-14,2000,100,1900,2
3,2023-09-15,3000,150,2850,3
4,2023-09-16,4000,200,3800,4
5,2023-09-17,5000,250,4750,5
6,2023-09-18,6000,300,5700,6
7,2023-09-19,7000,350,6650,7
8,2023-09-20,8000,400,7600,8
9,2023-09-21,9000,450,8550,9
10,2023-09-22,10000,500,9500,10